AU|ğŸ‡¦ğŸ‡º|ĞĞ²ÑÑ‚Ñ€Ğ°Ğ»Ğ¸Ñ|Australia|Australia
AT|ğŸ‡¦ğŸ‡¹|ĞĞ²ÑÑ‚Ñ€Ğ¸Ñ|Austria|Ã–sterreich
AZ|ğŸ‡¦ğŸ‡¿|ĞĞ·ĞµÑ€Ğ±Ğ°Ğ¹Ğ´Ğ¶Ğ°Ğ½|Azerbaijan|AzÉ™rbaycan
AL|ğŸ‡¦ğŸ‡±|ĞĞ»Ğ±Ğ°Ğ½Ğ¸Ñ|Albania|ShqipÃ«ria
DZ|ğŸ‡©ğŸ‡¿|ĞĞ»Ğ¶Ğ¸Ñ€|Algeria|Ø§Ù„Ø¬Ø²Ø§Ø¦Ø±
AS|ğŸ‡¦ğŸ‡¸|ĞĞ¼ĞµÑ€Ğ¸ĞºĞ°Ğ½ÑĞºĞ¾Ğµ Ğ¡Ğ°Ğ¼Ğ¾Ğ°|American Samoa|American Samoa
AI|ğŸ‡¦ğŸ‡®|ĞĞ½Ğ³Ğ¸Ğ»ÑŒÑ|Anguilla|Anguilla
AO|ğŸ‡¦ğŸ‡´|ĞĞ½Ğ³Ğ¾Ğ»Ğ°|Angola|Angola
AD|ğŸ‡¦ğŸ‡©|ĞĞ½Ğ´Ğ¾Ñ€Ñ€Ğ°|Andorra|Andorra
AG|ğŸ‡¦ğŸ‡¬|ĞĞ½Ñ‚Ğ¸Ğ³ÑƒĞ° Ğ¸ Ğ‘Ğ°Ñ€Ğ±ÑƒĞ´Ğ°|Antigua and Barbuda|Antigua and Barbuda
MO|ğŸ‡²ğŸ‡´|ĞœĞ°ĞºĞ°Ğ¾, ĞĞ¾Ğ¼Ñ‹Ğ½ÑŒ|Macao|æ¾³é–€
AR|ğŸ‡¦ğŸ‡·|ĞÑ€Ğ³ĞµĞ½Ñ‚Ğ¸Ğ½Ğ°|Argentina|Argentina
AM|ğŸ‡¦ğŸ‡²|ĞÑ€Ğ¼ĞµĞ½Ğ¸Ñ|Armenia|Õ€Õ¡ÕµÕ¡Õ½Õ¿Õ¡Õ¶
AW|ğŸ‡¦ğŸ‡¼|ĞÑ€ÑƒĞ±Ğ°|Aruba|Aruba
AF|ğŸ‡¦ğŸ‡«|ĞÑ„Ğ³Ğ°Ğ½Ğ¸ÑÑ‚Ğ°Ğ½|Afghanistan|Ø§ÙØºØ§Ù†Ø³ØªØ§Ù†
BS|ğŸ‡§ğŸ‡¸|Ğ‘Ğ°Ğ³Ğ°Ğ¼ÑĞºĞ¸Ğµ ĞÑÑ‚Ñ€Ğ¾Ğ²Ğ°|Bahamas|The Bahamas
BD|ğŸ‡§ğŸ‡©|Ğ‘Ğ°Ğ½Ğ³Ğ»Ğ°Ğ´ĞµÑˆ|Bangladesh|à¦¬à¦¾à¦‚à¦²à¦¾à¦¦à§‡à¦¶
BB|ğŸ‡§ğŸ‡§|Ğ‘Ğ°Ñ€Ğ±Ğ°Ğ´Ğ¾Ñ|Barbados|Barbados
BH|ğŸ‡§ğŸ‡­|Ğ‘Ğ°Ñ…Ñ€ĞµĞ¹Ğ½|Bahrain|Ø§Ù„Ø¨Ø­Ø±ÙŠÙ†â€â€â€â€â€â€
BZ|ğŸ‡§ğŸ‡¿|Ğ‘ĞµĞ»Ğ¸Ğ·|Belize|Belize
BY|ğŸ‡§ğŸ‡¾|Ğ‘ĞµĞ»Ğ¾Ñ€ÑƒÑÑĞ¸Ñ|Belarus|Ğ‘ĞµĞ»Ğ°Ñ€ÑƒÑÑŒ
BE|ğŸ‡§ğŸ‡ª|Ğ‘ĞµĞ»ÑŒĞ³Ğ¸Ñ|Belgium|Belgique
BJ|ğŸ‡§ğŸ‡¯|Ğ‘ĞµĞ½Ğ¸Ğ½|Benin|BÃ©nin
BM|ğŸ‡§ğŸ‡²|Ğ‘ĞµÑ€Ğ¼ÑƒĞ´ÑĞºĞ¸Ğµ ĞÑÑ‚Ñ€Ğ¾Ğ²Ğ°|Bermuda|Bermuda
BG|ğŸ‡§ğŸ‡¬|Ğ‘Ğ¾Ğ»Ğ³Ğ°Ñ€Ğ¸Ñ|Bulgaria|Ğ‘ÑŠĞ»Ğ³Ğ°Ñ€Ğ¸Ñ
BO|ğŸ‡§ğŸ‡´|Ğ‘Ğ¾Ğ»Ğ¸Ğ²Ğ¸Ñ|Bolivia|Bolivia
BQ|ğŸ‡§ğŸ‡¶|Ğ‘Ğ¾Ğ½Ğ°Ğ¹Ñ€Ğµ, Ğ¡Ğ¸Ğ½Ñ‚-Ğ­ÑÑ‚Ğ°Ñ‚Ğ¸ÑƒÑ Ğ¸ Ğ¡Ğ°Ğ±Ğ°|Bonaire, Sint Eustatius and Saba|Bonaire, Sint Eustatius en Saba
BA|ğŸ‡§ğŸ‡¦|Ğ‘Ğ¾ÑĞ½Ğ¸Ñ Ğ¸ Ğ“ĞµÑ€Ñ†ĞµĞ³Ğ¾Ğ²Ğ¸Ğ½Ğ°|Bosnia and Herzegovina|Ğ‘Ğ¾ÑĞ½Ğ° Ğ¸ Ğ¥ĞµÑ€Ñ†ĞµĞ³Ğ¾Ğ²Ğ¸Ğ½Ğ°
BW|ğŸ‡§ğŸ‡¼|Ğ‘Ğ¾Ñ‚ÑĞ²Ğ°Ğ½Ğ°|Botswana|Botswana
BR|ğŸ‡§ğŸ‡·|Ğ‘Ñ€Ğ°Ğ·Ğ¸Ğ»Ğ¸Ñ|Brazil|Brasil
IO|ğŸ‡®ğŸ‡´|Ğ‘Ñ€Ğ¸Ñ‚Ğ°Ğ½ÑĞºĞ°Ñ Ñ‚ĞµÑ€Ñ€Ğ¸Ñ‚Ğ¾Ñ€Ğ¸Ñ Ğ² Ğ˜Ğ½Ğ´Ğ¸Ğ¹ÑĞºĞ¾Ğ¼ Ğ¾ĞºĞµĞ°Ğ½Ğµ|British Indian Ocean Territory|British Indian Ocean Territory
BN|ğŸ‡§ğŸ‡³|Ğ‘Ñ€ÑƒĞ½ĞµĞ¹|Brunei Darussalam|Ø¨Ø±ÙˆÙ†ÙŠ
BF|ğŸ‡§ğŸ‡«|Ğ‘ÑƒÑ€ĞºĞ¸Ğ½Ğ°-Ğ¤Ğ°ÑĞ¾|Burkina Faso|Burkina Faso
BI|ğŸ‡§ğŸ‡®|Ğ‘ÑƒÑ€ÑƒĞ½Ğ´Ğ¸|Burundi|Burundi
BT|ğŸ‡§ğŸ‡¹|Ğ‘ÑƒÑ‚Ğ°Ğ½|Bhutan|à½ à½–à¾²à½´à½‚à¼‹à½¡à½´à½£
VU|ğŸ‡»ğŸ‡º|Ğ’Ğ°Ğ½ÑƒĞ°Ñ‚Ñƒ|Vanuatu|Vanuatu
VA|ğŸ‡»ğŸ‡¦|Ğ’Ğ°Ñ‚Ğ¸ĞºĞ°Ğ½|Vatican City|Civitas Vaticana
GB|ğŸ‡¬ğŸ‡§|Ğ’ĞµĞ»Ğ¸ĞºĞ¾Ğ±Ñ€Ğ¸Ñ‚Ğ°Ğ½Ğ¸Ñ|United Kingdom|United Kingdom
HU|ğŸ‡­ğŸ‡º|Ğ’ĞµĞ½Ğ³Ñ€Ğ¸Ñ|Hungary|MagyarorszÃ¡g
VE|ğŸ‡»ğŸ‡ª|Ğ’ĞµĞ½ĞµÑÑƒÑĞ»Ğ°|Venezuela|Venezuela
VI|ğŸ‡»ğŸ‡®|Ğ’Ğ¸Ñ€Ğ³Ğ¸Ğ½ÑĞºĞ¸Ğµ ĞÑÑ‚Ñ€Ğ¾Ğ²Ğ° (Ğ¡Ğ¨Ğ)|Virgin Islands, U.S.|United States Virgin Islands
VG|ğŸ‡»ğŸ‡¬|Ğ’Ğ¸Ñ€Ğ³Ğ¸Ğ½ÑĞºĞ¸Ğµ ĞÑÑ‚Ñ€Ğ¾Ğ²Ğ° (Ğ’ĞµĞ»Ğ¸ĞºĞ¾Ğ±Ñ€Ğ¸Ñ‚Ğ°Ğ½Ğ¸Ñ)|Virgin Islands, British|British Virgin Islands
TL|ğŸ‡¹ğŸ‡±|Ğ’Ğ¾ÑÑ‚Ğ¾Ñ‡Ğ½Ñ‹Ğ¹ Ğ¢Ğ¸Ğ¼Ğ¾Ñ€|Timor-Leste|Timor Lorosaâ€™e
VN|ğŸ‡»ğŸ‡³|Ğ’ÑŒĞµÑ‚Ğ½Ğ°Ğ¼|Viet Nam|Viá»‡t Nam
GA|ğŸ‡¬ğŸ‡¦|Ğ“Ğ°Ğ±Ğ¾Ğ½|Gabon|Gabon
HT|ğŸ‡­ğŸ‡¹|Ğ“Ğ°Ğ¸Ñ‚Ğ¸|Haiti|HaÃ¯ti
GY|ğŸ‡¬ğŸ‡¾|Ğ“Ğ°Ğ¹Ğ°Ğ½Ğ°|Guyana|Guyana
GM|ğŸ‡¬ğŸ‡²|Ğ“Ğ°Ğ¼Ğ±Ğ¸Ñ|Gambia|The Gambia
GH|ğŸ‡¬ğŸ‡­|Ğ“Ğ°Ğ½Ğ°|Ghana|Ghana
GP|ğŸ‡¬ğŸ‡µ|Ğ“Ğ²Ğ°Ğ´ĞµĞ»ÑƒĞ¿Ğ°|Guadeloupe|Guadeloupe
GT|ğŸ‡¬ğŸ‡¹|Ğ“Ğ²Ğ°Ñ‚ĞµĞ¼Ğ°Ğ»Ğ°|Guatemala|Guatemala
GN|ğŸ‡¬ğŸ‡³|Ğ“Ğ²Ğ¸Ğ½ĞµÑ|Guinea|GuinÃ©e
GW|ğŸ‡¬ğŸ‡¼|Ğ“Ğ²Ğ¸Ğ½ĞµÑ-Ğ‘Ğ¸ÑĞ°Ñƒ|Guinea-Bissau|GuinÃ©-Bissau
DE|ğŸ‡©ğŸ‡ª|Ğ“ĞµÑ€Ğ¼Ğ°Ğ½Ğ¸Ñ|Germany|Deutschland
GG|ğŸ‡¬ğŸ‡¬|Ğ“ĞµÑ€Ğ½ÑĞ¸|Guernsey|Guernsey
GI|ğŸ‡¬ğŸ‡®|Ğ“Ğ¸Ğ±Ñ€Ğ°Ğ»Ñ‚Ğ°Ñ€|Gibraltar|Gibraltar
HN|ğŸ‡­ğŸ‡³|Ğ“Ğ¾Ğ½Ğ´ÑƒÑ€Ğ°Ñ|Honduras|Honduras
HK|ğŸ‡­ğŸ‡°|Ğ“Ğ¾Ğ½ĞºĞ¾Ğ½Ğ³|Hong Kong|é¦™æ¸¯
GD|ğŸ‡¬ğŸ‡©|Ğ“Ñ€ĞµĞ½Ğ°Ğ´Ğ°|Grenada|Grenada
GL|ğŸ‡¬ğŸ‡±|Ğ“Ñ€ĞµĞ½Ğ»Ğ°Ğ½Ğ´Ğ¸Ñ|Greenland|Kalaallit Nunaat
GR|ğŸ‡¬ğŸ‡·|Ğ“Ñ€ĞµÑ†Ğ¸Ñ|Greece|Î•Î»Î»Î¬Î´Î±
GE|ğŸ‡¬ğŸ‡ª|Ğ“Ñ€ÑƒĞ·Ğ¸Ñ|Georgia|áƒ¡áƒáƒ¥áƒáƒ áƒ—áƒ•áƒ”áƒšáƒ
GU|ğŸ‡¬ğŸ‡º|Ğ“ÑƒĞ°Ğ¼|Guam|Guam
DK|ğŸ‡©ğŸ‡°|Ğ”Ğ°Ğ½Ğ¸Ñ|Denmark|Danmark
JE|ğŸ‡¯ğŸ‡ª|Ğ”Ğ¶ĞµÑ€ÑĞ¸|Jersey|Jersey
DJ|ğŸ‡©ğŸ‡¯|Ğ”Ğ¶Ğ¸Ğ±ÑƒÑ‚Ğ¸|Djibouti|Ø¬ÙŠØ¨ÙˆØªÙŠ
DM|ğŸ‡©ğŸ‡²|Ğ”Ğ¾Ğ¼Ğ¸Ğ½Ğ¸ĞºĞ°|Dominica|Dominica
DO|ğŸ‡©ğŸ‡´|Ğ”Ğ¾Ğ¼Ğ¸Ğ½Ğ¸ĞºĞ°Ğ½ÑĞºĞ°Ñ Ğ ĞµÑĞ¿ÑƒĞ±Ğ»Ğ¸ĞºĞ°|Dominican Republic|RepÃºblica Dominicana
EG|ğŸ‡ªğŸ‡¬|Ğ•Ğ³Ğ¸Ğ¿ĞµÑ‚|Egypt|Ù…ØµØ±
ZM|ğŸ‡¿ğŸ‡²|Ğ—Ğ°Ğ¼Ğ±Ğ¸Ñ|Zambia|Zambia
ZW|ğŸ‡¿ğŸ‡¼|Ğ—Ğ¸Ğ¼Ğ±Ğ°Ğ±Ğ²Ğµ|Zimbabwe|Zimbabwe
IL|ğŸ‡®ğŸ‡±|Ğ˜Ğ·Ñ€Ğ°Ğ¸Ğ»ÑŒ|Israel|â€×™Ö´×©Ö°×‚×¨Ö¸×Öµ×œ
IN|ğŸ‡®ğŸ‡³|Ğ˜Ğ½Ğ´Ğ¸Ñ|India|à¤­à¤¾à¤°à¤¤, à¤¹à¤¿à¤‚à¤¦à¥à¤¸à¥à¤¤à¤¾à¤¨
ID|ğŸ‡®ğŸ‡©|Ğ˜Ğ½Ğ´Ğ¾Ğ½ĞµĞ·Ğ¸Ñ|Indonesia|Indonesia
JO|ğŸ‡¯ğŸ‡´|Ğ˜Ğ¾Ñ€Ğ´Ğ°Ğ½Ğ¸Ñ|Jordan|Ø§Ù„Ø£Ø±Ø¯Ù†
IQ|ğŸ‡®ğŸ‡¶|Ğ˜Ñ€Ğ°Ğº|Iraq|Ø§Ù„Ù’Ø¹ÙØ±ÙØ§Ù‚
IR|ğŸ‡®ğŸ‡·|Ğ˜Ñ€Ğ°Ğ½|Iran|Ø§ÛŒØ±Ø§Ù†
IE|ğŸ‡®ğŸ‡ª|Ğ˜Ñ€Ğ»Ğ°Ğ½Ğ´Ğ¸Ñ|Ireland|Ã‰ire
IS|ğŸ‡®ğŸ‡¸|Ğ˜ÑĞ»Ğ°Ğ½Ğ´Ğ¸Ñ|Iceland|Ãsland
ES|ğŸ‡ªğŸ‡¸|Ğ˜ÑĞ¿Ğ°Ğ½Ğ¸Ñ|Spain|EspaÃ±a
IT|ğŸ‡®ğŸ‡¹|Ğ˜Ñ‚Ğ°Ğ»Ğ¸Ñ|Italy|Italia
YE|ğŸ‡¾ğŸ‡ª|Ğ™ĞµĞ¼ĞµĞ½|Yemen|Ù±Ù„Ù’ÙŠÙÙ…ÙÙ†
CV|ğŸ‡¨ğŸ‡»|ĞšĞ°Ğ±Ğ¾-Ğ’ĞµÑ€Ğ´Ğµ|Cape Verde|Cabo Verde
KZ|ğŸ‡°ğŸ‡¿|ĞšĞ°Ğ·Ğ°Ñ…ÑÑ‚Ğ°Ğ½|Kazakhstan|ÒšĞ°Ğ·Ğ°Ò›ÑÑ‚Ğ°Ğ½
KH|ğŸ‡°ğŸ‡­|ĞšĞ°Ğ¼Ğ±Ğ¾Ğ´Ğ¶Ğ°|Cambodia|á€á˜áŸ’á–á»á‡á¶
CM|ğŸ‡¨ğŸ‡²|ĞšĞ°Ğ¼ĞµÑ€ÑƒĞ½|Cameroon|Cameroun
CA|ğŸ‡¨ğŸ‡¦|ĞšĞ°Ğ½Ğ°Ğ´Ğ°|Canada|Canada
QA|ğŸ‡¶ğŸ‡¦|ĞšĞ°Ñ‚Ğ°Ñ€|Qatar|Ù‚Ø·Ø±
KE|ğŸ‡°ğŸ‡ª|ĞšĞµĞ½Ğ¸Ñ|Kenya|Kenya
CY|ğŸ‡¨ğŸ‡¾|ĞšĞ¸Ğ¿Ñ€|Cyprus|ÎšÏÏ€ÏÎ¿Ï‚
KG|ğŸ‡°ğŸ‡¬|ĞšĞ¸Ñ€Ğ³Ğ¸Ğ·Ğ¸Ñ|Kyrgyzstan|ĞšÑ‹Ñ€Ğ³Ñ‹Ğ·ÑÑ‚Ğ°Ğ½
KI|ğŸ‡°ğŸ‡®|ĞšĞ¸Ñ€Ğ¸Ğ±Ğ°Ñ‚Ğ¸|Kiribati|Kiribati
TW|ğŸ‡¹ğŸ‡¼|ĞšĞ¸Ñ‚Ğ°Ğ¹|Taiwan|ä¸­å›½
CO|ğŸ‡¨ğŸ‡´|ĞšĞ¾Ğ»ÑƒĞ¼Ğ±Ğ¸Ñ|Colombia|Colombia
KM|ğŸ‡°ğŸ‡²|ĞšĞ¾Ğ¼Ğ¾Ñ€Ñ‹|Comoros|Komori
CD|ğŸ‡¨ğŸ‡©|Ğ”ĞµĞ¼Ğ¾ĞºÑ€Ğ°Ñ‚Ğ¸Ñ‡ĞµÑĞºĞ°Ñ Ğ ĞµÑĞ¿ÑƒĞ±Ğ»Ğ¸ĞºĞ° ĞšĞ¾Ğ½Ğ³Ğ¾|Congo|RÃ©publique DÃ©mocratique du Congo
CG|ğŸ‡¨ğŸ‡¬|Ğ ĞµÑĞ¿ÑƒĞ±Ğ»Ğ¸ĞºĞ° ĞšĞ¾Ğ½Ğ³Ğ¾|Congo|Congo
KP|ğŸ‡°ğŸ‡µ|ĞšĞĞ”Ğ |North Korea|ì¡°ì„  / æœé®®; ë¶ì¡°ì„  / åŒ—æœé®®
KR|ğŸ‡°ğŸ‡·|Ğ ĞµÑĞ¿ÑƒĞ±Ğ»Ğ¸ĞºĞ° ĞšĞ¾Ñ€ĞµÑ|South Korea|í•œêµ­ / éŸ“åœ‹; ë‚¨í•œ, å—éŸ“
CR|ğŸ‡¨ğŸ‡·|ĞšĞ¾ÑÑ‚Ğ°-Ğ Ğ¸ĞºĞ°|Costa Rica|Costa Rica
CI|ğŸ‡¨ğŸ‡®|ĞšĞ¾Ñ‚-Ğ´â€™Ğ˜Ğ²ÑƒĞ°Ñ€|CÃ´te Dâ€™Ivoire|CÃ´te dâ€™Ivoire
CU|ğŸ‡¨ğŸ‡º|ĞšÑƒĞ±Ğ°|Cuba|Cuba
KW|ğŸ‡°ğŸ‡¼|ĞšÑƒĞ²ĞµĞ¹Ñ‚|Kuwait|Ø§Ù„ÙƒÙˆÙŠØª
CW|ğŸ‡¨ğŸ‡¼|ĞšÑÑ€Ğ°ÑĞ°Ğ¾|CuraÃ§ao|Land CuraÃ§ao
LA|ğŸ‡±ğŸ‡¦|Ğ›Ğ°Ğ¾Ñ|Lao Peopleâ€™s Democratic Republic|àº¥àº²àº§
LV|ğŸ‡±ğŸ‡»|Ğ›Ğ°Ñ‚Ğ²Ğ¸Ñ|Latvia|Latvija
LS|ğŸ‡±ğŸ‡¸|Ğ›ĞµÑĞ¾Ñ‚Ğ¾|Lesotho|Lesotho
LR|ğŸ‡±ğŸ‡·|Ğ›Ğ¸Ğ±ĞµÑ€Ğ¸Ñ|Liberia|Liberia
LB|ğŸ‡±ğŸ‡§|Ğ›Ğ¸Ğ²Ğ°Ğ½|Lebanon|Ù„ÙØ¨Ù’Ù†ÙØ§Ù†
LY|ğŸ‡±ğŸ‡¾|Ğ›Ğ¸Ğ²Ğ¸Ñ|Libya|Ù„ÙŠØ¨ÙŠØ§
LT|ğŸ‡±ğŸ‡¹|Ğ›Ğ¸Ñ‚Ğ²Ğ°|Lithuania|Lietuva
LI|ğŸ‡±ğŸ‡®|Ğ›Ğ¸Ñ…Ñ‚ĞµĞ½ÑˆÑ‚ĞµĞ¹Ğ½|Liechtenstein|Liechtenstein
LU|ğŸ‡±ğŸ‡º|Ğ›ÑĞºÑĞµĞ¼Ğ±ÑƒÑ€Ğ³|Luxembourg|LÃ«tzebuerg
MU|ğŸ‡²ğŸ‡º|ĞœĞ°Ğ²Ñ€Ğ¸ĞºĞ¸Ğ¹|Mauritius|Mauritius
MR|ğŸ‡²ğŸ‡·|ĞœĞ°Ğ²Ñ€Ğ¸Ñ‚Ğ°Ğ½Ğ¸Ñ|Mauritania|Ù…ÙˆØ±ÙŠØªØ§Ù†ÙŠØ§
MG|ğŸ‡²ğŸ‡¬|ĞœĞ°Ğ´Ğ°Ğ³Ğ°ÑĞºĞ°Ñ€|Madagascar|Madagasikara
YT|ğŸ‡¾ğŸ‡¹|ĞœĞ°Ğ¹Ğ¾Ñ‚Ñ‚Ğ°|Mayotte|Mayotte
MW|ğŸ‡²ğŸ‡¼|ĞœĞ°Ğ»Ğ°Ğ²Ğ¸|Malawi|Malawi
MY|ğŸ‡²ğŸ‡¾|ĞœĞ°Ğ»Ğ°Ğ¹Ğ·Ğ¸Ñ|Malaysia|Malaysia
ML|ğŸ‡²ğŸ‡±|ĞœĞ°Ğ»Ğ¸|Mali|Mali
MV|ğŸ‡²ğŸ‡»|ĞœĞ°Ğ»ÑŒĞ´Ğ¸Ğ²Ñ‹|Maldives|Ş€Ş¨ŞˆŞ¬Ş‹Ş¨ ŞŞªŞ–Ş­Ş‡Ş°ŞƒŞ§
MT|ğŸ‡²ğŸ‡¹|ĞœĞ°Ğ»ÑŒÑ‚Ğ°|Malta|Malta
MA|ğŸ‡²ğŸ‡¦|ĞœĞ°Ñ€Ğ¾ĞºĞºĞ¾|Morocco|Ø§Ù„Ù…ØºØ±Ø¨
MQ|ğŸ‡²ğŸ‡¶|ĞœĞ°Ñ€Ñ‚Ğ¸Ğ½Ğ¸ĞºĞ°|Martinique|Martinique
MH|ğŸ‡²ğŸ‡­|ĞœĞ°Ñ€ÑˆĞ°Ğ»Ğ»Ğ¾Ğ²Ñ‹ ĞÑÑ‚Ñ€Ğ¾Ğ²Ğ°|Marshall Islands|Marshall Islands
MX|ğŸ‡²ğŸ‡½|ĞœĞµĞºÑĞ¸ĞºĞ°|Mexico|MÃ©xico
MZ|ğŸ‡²ğŸ‡¿|ĞœĞ¾Ğ·Ğ°Ğ¼Ğ±Ğ¸Ğº|Mozambique|MoÃ§ambique
MD|ğŸ‡²ğŸ‡©|ĞœĞ¾Ğ»Ğ´Ğ°Ğ²Ğ¸Ñ|Moldova|Moldova
MC|ğŸ‡²ğŸ‡¨|ĞœĞ¾Ğ½Ğ°ĞºĞ¾|Monaco|Monaco
MN|ğŸ‡²ğŸ‡³|ĞœĞ¾Ğ½Ğ³Ğ¾Ğ»Ğ¸Ñ|Mongolia|ĞœĞ¾Ğ½Ğ³Ğ¾Ğ» Ğ£Ğ»Ñ
MS|ğŸ‡²ğŸ‡¸|ĞœĞ¾Ğ½Ñ‚ÑĞµÑ€Ñ€Ğ°Ñ‚|Montserrat|Montserrat
MM|ğŸ‡²ğŸ‡²|ĞœÑŒÑĞ½Ğ¼Ğ°|Myanmar|á€™á€¼á€”á€ºá€™á€¬
NA|ğŸ‡³ğŸ‡¦|ĞĞ°Ğ¼Ğ¸Ğ±Ğ¸Ñ|Namibia|Namibia
NR|ğŸ‡³ğŸ‡·|ĞĞ°ÑƒÑ€Ñƒ|Nauru|Naoero
NP|ğŸ‡³ğŸ‡µ|ĞĞµĞ¿Ğ°Ğ»|Nepal|à¤¨à¥‡à¤ªà¤¾à¤²
NE|ğŸ‡³ğŸ‡ª|ĞĞ¸Ğ³ĞµÑ€|Niger|Niger
NG|ğŸ‡³ğŸ‡¬|ĞĞ¸Ğ³ĞµÑ€Ğ¸Ñ|Nigeria|Nigeria
NL|ğŸ‡³ğŸ‡±|ĞĞ¸Ğ´ĞµÑ€Ğ»Ğ°Ğ½Ğ´Ñ‹|Netherlands|Nederland
NI|ğŸ‡³ğŸ‡®|ĞĞ¸ĞºĞ°Ñ€Ğ°Ğ³ÑƒĞ°|Nicaragua|Nicaragua
NU|ğŸ‡³ğŸ‡º|ĞĞ¸ÑƒÑ|Niue|Niue
NZ|ğŸ‡³ğŸ‡¿|ĞĞ¾Ğ²Ğ°Ñ Ğ—ĞµĞ»Ğ°Ğ½Ğ´Ğ¸Ñ|New Zealand|New Zealand
NC|ğŸ‡³ğŸ‡¨|ĞĞ¾Ğ²Ğ°Ñ ĞšĞ°Ğ»ĞµĞ´Ğ¾Ğ½Ğ¸Ñ|New Caledonia|Nouvelle-CalÃ©donie
NO|ğŸ‡³ğŸ‡´|ĞĞ¾Ñ€Ğ²ĞµĞ³Ğ¸Ñ|Norway|Norge
AE|ğŸ‡¦ğŸ‡ª|ĞĞĞ­|United Arab Emirates|Ø§Ù„Ø¥Ù…Ø§Ø±Ø§Øª
OM|ğŸ‡´ğŸ‡²|ĞĞ¼Ğ°Ğ½|Oman|Ø¹ÙÙ…Ø§Ù†
KY|ğŸ‡°ğŸ‡¾|ĞÑÑ‚Ñ€Ğ¾Ğ²Ğ° ĞšĞ°Ğ¹Ğ¼Ğ°Ğ½|Cayman Islands|Cayman Islands
CK|ğŸ‡¨ğŸ‡°|ĞÑÑ‚Ñ€Ğ¾Ğ²Ğ° ĞšÑƒĞºĞ°|Cook Islands|Cook Islands
PN|ğŸ‡µğŸ‡³|ĞÑÑ‚Ñ€Ğ¾Ğ²Ğ° ĞŸĞ¸Ñ‚ĞºÑÑ€Ğ½|Pitcairn|Pitcairn Islands
SH|ğŸ‡¸ğŸ‡­|ĞÑÑ‚Ñ€Ğ¾Ğ²Ğ° Ğ¡Ğ²ÑÑ‚Ğ¾Ğ¹ Ğ•Ğ»ĞµĞ½Ñ‹, Ğ’Ğ¾Ğ·Ğ½ĞµÑĞµĞ½Ğ¸Ñ Ğ¸ Ğ¢Ñ€Ğ¸ÑÑ‚Ğ°Ğ½-Ğ´Ğ°-ĞšÑƒĞ½ÑŒÑ|Saint Helena, Ascension and Tristan Da Cunha|Saint Helena, Ascension and Tristan da Cunha
NF|ğŸ‡³ğŸ‡«|ĞÑÑ‚Ñ€Ğ¾Ğ² ĞĞ¾Ñ€Ñ„Ğ¾Ğ»Ğº|Norfolk Island|Norfolk Island
CX|ğŸ‡¨ğŸ‡½|ĞÑÑ‚Ñ€Ğ¾Ğ² Ğ Ğ¾Ğ¶Ğ´ĞµÑÑ‚Ğ²Ğ°|Christmas Island|Christmas Island
PK|ğŸ‡µğŸ‡°|ĞŸĞ°ĞºĞ¸ÑÑ‚Ğ°Ğ½|Pakistan|Ù¾Ø§Ú©Ø³ØªØ§Ù†
PW|ğŸ‡µğŸ‡¼|ĞŸĞ°Ğ»Ğ°Ñƒ|Palau|Palau
PA|ğŸ‡µğŸ‡¦|ĞŸĞ°Ğ½Ğ°Ğ¼Ğ°|Panama|PanamÃ¡
PG|ğŸ‡µğŸ‡¬|ĞŸĞ°Ğ¿ÑƒĞ° â€” ĞĞ¾Ğ²Ğ°Ñ Ğ“Ğ²Ğ¸Ğ½ĞµÑ|Papua New Guinea|Papua New Guinea
PY|ğŸ‡µğŸ‡¾|ĞŸĞ°Ñ€Ğ°Ğ³Ğ²Ğ°Ğ¹|Paraguay|Paraguay
PE|ğŸ‡µğŸ‡ª|ĞŸĞµÑ€Ñƒ|Peru|PerÃº
PL|ğŸ‡µğŸ‡±|ĞŸĞ¾Ğ»ÑŒÑˆĞ°|Poland|Polska
PT|ğŸ‡µğŸ‡¹|ĞŸĞ¾Ñ€Ñ‚ÑƒĞ³Ğ°Ğ»Ğ¸Ñ|Portugal|Portugal
PR|ğŸ‡µğŸ‡·|ĞŸÑƒÑÑ€Ñ‚Ğ¾-Ğ Ğ¸ĞºĞ¾|Puerto Rico|Puerto Rico
RE|ğŸ‡·ğŸ‡ª|Ğ ĞµÑĞ½ÑŒĞ¾Ğ½|RÃ©union|RÃ©union
RU|ğŸ‡·ğŸ‡º|Ğ Ğ¾ÑÑĞ¸Ñ|Russia|Ğ Ğ¾ÑÑĞ¸Ñ
RW|ğŸ‡·ğŸ‡¼|Ğ ÑƒĞ°Ğ½Ğ´Ğ°|Rwanda|Rwanda
RO|ğŸ‡·ğŸ‡´|Ğ ÑƒĞ¼Ñ‹Ğ½Ğ¸Ñ|Romania|RomÃ¢nia
SV|ğŸ‡¸ğŸ‡»|Ğ¡Ğ°Ğ»ÑŒĞ²Ğ°Ğ´Ğ¾Ñ€|El Salvador|El Salvador
WS|ğŸ‡¼ğŸ‡¸|Ğ¡Ğ°Ğ¼Ğ¾Ğ°|Samoa|Samoa
SM|ğŸ‡¸ğŸ‡²|Ğ¡Ğ°Ğ½-ĞœĞ°Ñ€Ğ¸Ğ½Ğ¾|San Marino|San Marino
ST|ğŸ‡¸ğŸ‡¹|Ğ¡Ğ°Ğ½-Ğ¢Ğ¾Ğ¼Ğµ Ğ¸ ĞŸÑ€Ğ¸Ğ½ÑĞ¸Ğ¿Ğ¸|Sao Tome and Principe|SÃ£o TomÃ© and PrÃ­ncipe
SA|ğŸ‡¸ğŸ‡¦|Ğ¡Ğ°ÑƒĞ´Ğ¾Ğ²ÑĞºĞ°Ñ ĞÑ€Ğ°Ğ²Ğ¸Ñ|Saudi Arabia|Ù±Ù„Ø³ÙÙ‘Ø¹ÙÙˆÙ’Ø¯ÙÙŠÙÙ‘Ø© Ø§Ù„Ø¹Ø±Ø¨ÙŠÙ‘Ø©
MK|ğŸ‡²ğŸ‡°|Ğ¡ĞµĞ²ĞµÑ€Ğ½Ğ°Ñ ĞœĞ°ĞºĞµĞ´Ğ¾Ğ½Ğ¸Ñ|Macedonia|Ğ¡ĞµĞ²ĞµÑ€Ğ½Ğ° ĞœĞ°ĞºĞµĞ´Ğ¾Ğ½Ğ¸Ñ˜Ğ°
MP|ğŸ‡²ğŸ‡µ|Ğ¡ĞµĞ²ĞµÑ€Ğ½Ñ‹Ğµ ĞœĞ°Ñ€Ğ¸Ğ°Ğ½ÑĞºĞ¸Ğµ ĞÑÑ‚Ñ€Ğ¾Ğ²Ğ°|Northern Mariana Islands|Northern Mariana Islands
SC|ğŸ‡¸ğŸ‡¨|Ğ¡ĞµĞ¹ÑˆĞµĞ»ÑŒÑĞºĞ¸Ğµ ĞÑÑ‚Ñ€Ğ¾Ğ²Ğ°|Seychelles|Sesel
SN|ğŸ‡¸ğŸ‡³|Ğ¡ĞµĞ½ĞµĞ³Ğ°Ğ»|Senegal|SÃ©nÃ©gal
BL|ğŸ‡§ğŸ‡±|Ğ¡ĞµĞ½-Ğ‘Ğ°Ñ€Ñ‚ĞµĞ»ĞµĞ¼Ğ¸|Saint BarthÃ©lemy|Saint-BarthÃ©lemy
MF|ğŸ‡²ğŸ‡«|Ğ¡ĞµĞ½-ĞœĞ°Ñ€Ñ‚ĞµĞ½|Saint Martin (French Part)|Saint-Martin
PM|ğŸ‡µğŸ‡²|Ğ¡ĞµĞ½-ĞŸÑŒĞµÑ€ Ğ¸ ĞœĞ¸ĞºĞµĞ»Ğ¾Ğ½|Saint Pierre and Miquelon|Saint-Pierre et Miquelon
VC|ğŸ‡»ğŸ‡¨|Ğ¡ĞµĞ½Ñ‚-Ğ’Ğ¸Ğ½ÑĞµĞ½Ñ‚ Ğ¸ Ğ“Ñ€ĞµĞ½Ğ°Ğ´Ğ¸Ğ½Ñ‹|Saint Vincent and The Grenadines|Saint Vincent and the Grenadines
KN|ğŸ‡°ğŸ‡³|Ğ¡ĞµĞ½Ñ‚-ĞšĞ¸Ñ‚Ñ Ğ¸ ĞĞµĞ²Ğ¸Ñ|Saint Kitts and Nevis|Saint Kitts and Nevis
LC|ğŸ‡±ğŸ‡¨|Ğ¡ĞµĞ½Ñ‚-Ğ›ÑÑĞ¸Ñ|Saint Lucia|Saint Lucia
RS|ğŸ‡·ğŸ‡¸|Ğ¡ĞµÑ€Ğ±Ğ¸Ñ|Serbia|Ğ¡Ñ€Ğ±Ğ¸Ñ˜Ğ°
SG|ğŸ‡¸ğŸ‡¬|Ğ¡Ğ¸Ğ½Ğ³Ğ°Ğ¿ÑƒÑ€|Singapore|Singapura
SX|ğŸ‡¸ğŸ‡½|Ğ¡Ğ¸Ğ½Ñ‚-ĞœĞ°Ñ€Ñ‚ĞµĞ½|Sint Maarten (Dutch Part)|Sint Maarten
SY|ğŸ‡¸ğŸ‡¾|Ğ¡Ğ¸Ñ€Ğ¸Ñ|Syrian Arab Republic|Ø³ÙÙˆØ±ÙÙŠÙØ©
SK|ğŸ‡¸ğŸ‡°|Ğ¡Ğ»Ğ¾Ğ²Ğ°ĞºĞ¸Ñ|Slovakia|Slovensko
SI|ğŸ‡¸ğŸ‡®|Ğ¡Ğ»Ğ¾Ğ²ĞµĞ½Ğ¸Ñ|Slovenia|Slovenija
US|ğŸ‡ºğŸ‡¸|Ğ¡Ğ¾ĞµĞ´Ğ¸Ğ½Ñ‘Ğ½Ğ½Ñ‹Ğµ Ğ¨Ñ‚Ğ°Ñ‚Ñ‹ ĞĞ¼ĞµÑ€Ğ¸ĞºĞ¸|United States|United States of America
SB|ğŸ‡¸ğŸ‡§|Ğ¡Ğ¾Ğ»Ğ¾Ğ¼Ğ¾Ğ½Ğ¾Ğ²Ñ‹ ĞÑÑ‚Ñ€Ğ¾Ğ²Ğ°|Solomon Islands|Solomon Islands
SO|ğŸ‡¸ğŸ‡´|Ğ¡Ğ¾Ğ¼Ğ°Ğ»Ğ¸|Somalia|Soomaaliya
SD|ğŸ‡¸ğŸ‡©|Ğ¡ÑƒĞ´Ğ°Ğ½|Sudan|Ø§Ù„Ø³ÙˆØ¯Ø§Ù†
SR|ğŸ‡¸ğŸ‡·|Ğ¡ÑƒÑ€Ğ¸Ğ½Ğ°Ğ¼|Suriname|Suriname
SL|ğŸ‡¸ğŸ‡±|Ğ¡ÑŒĞµÑ€Ñ€Ğ°-Ğ›ĞµĞ¾Ğ½Ğµ|Sierra Leone|Sierra Leone
TJ|ğŸ‡¹ğŸ‡¯|Ğ¢Ğ°Ğ´Ğ¶Ğ¸ĞºĞ¸ÑÑ‚Ğ°Ğ½|Tajikistan|Ğ¢Ğ¾Ò·Ğ¸ĞºĞ¸ÑÑ‚Ğ¾Ğ½
TH|ğŸ‡¹ğŸ‡­|Ğ¢Ğ°Ğ¸Ğ»Ğ°Ğ½Ğ´|Thailand|à¹€à¸¡à¸·à¸­à¸‡à¹„à¸—à¸¢; à¸›à¸£à¸°à¹€à¸—à¸¨à¹„à¸—à¸¢; à¸£à¸²à¸Šà¸­à¸²à¸“à¸²à¸ˆà¸±à¸à¸£à¹„à¸—à¸¢
TZ|ğŸ‡¹ğŸ‡¿|Ğ¢Ğ°Ğ½Ğ·Ğ°Ğ½Ğ¸Ñ|Tanzania|Tanzania
TC|ğŸ‡¹ğŸ‡¨|Ğ¢ĞµÑ€ĞºÑ Ğ¸ ĞšĞ°Ğ¹ĞºĞ¾Ñ|Turks and Caicos Islands|Turks and Caicos Islands
TG|ğŸ‡¹ğŸ‡¬|Ğ¢Ğ¾Ğ³Ğ¾|Togo|Togo
TK|ğŸ‡¹ğŸ‡°|Ğ¢Ğ¾ĞºĞµĞ»Ğ°Ñƒ|Tokelau|Tokelau
TO|ğŸ‡¹ğŸ‡´|Ğ¢Ğ¾Ğ½Ğ³Ğ°|Tonga|Tonga
TT|ğŸ‡¹ğŸ‡¹|Ğ¢Ñ€Ğ¸Ğ½Ğ¸Ğ´Ğ°Ğ´ Ğ¸ Ğ¢Ğ¾Ğ±Ğ°Ğ³Ğ¾|Trinidad and Tobago|Trinidad and Tobago
TV|ğŸ‡¹ğŸ‡»|Ğ¢ÑƒĞ²Ğ°Ğ»Ñƒ|Tuvalu|Tuvalu
TN|ğŸ‡¹ğŸ‡³|Ğ¢ÑƒĞ½Ğ¸Ñ|Tunisia|ØªÙˆÙ†Ø³Â 
TM|ğŸ‡¹ğŸ‡²|Ğ¢ÑƒÑ€ĞºĞ¼ĞµĞ½Ğ¸Ñ|Turkmenistan|TÃ¼rkmenistan
TR|ğŸ‡¹ğŸ‡·|Ğ¢ÑƒÑ€Ñ†Ğ¸Ñ|Turkey|TÃ¼rkiye
UG|ğŸ‡ºğŸ‡¬|Ğ£Ğ³Ğ°Ğ½Ğ´Ğ°|Uganda|Uganda
UZ|ğŸ‡ºğŸ‡¿|Ğ£Ğ·Ğ±ĞµĞºĞ¸ÑÑ‚Ğ°Ğ½|Uzbekistan|OÊ»zbekiston
UA|ğŸ‡ºğŸ‡¦|Ğ£ĞºÑ€Ğ°Ğ¸Ğ½Ğ°|Ukraine|Ğ£ĞºÑ€Ğ°Ñ—Ğ½Ğ°
WF|ğŸ‡¼ğŸ‡«|Ğ£Ğ¾Ğ»Ğ»Ğ¸Ñ Ğ¸ Ğ¤ÑƒÑ‚ÑƒĞ½Ğ°|Wallis and Futuna|Wallis-et-Futuna
UY|ğŸ‡ºğŸ‡¾|Ğ£Ñ€ÑƒĞ³Ğ²Ğ°Ğ¹|Uruguay|Uruguay
FM|ğŸ‡«ğŸ‡²|ĞœĞ¸ĞºÑ€Ğ¾Ğ½ĞµĞ·Ğ¸Ñ|Micronesia|Micronesia
FJ|ğŸ‡«ğŸ‡¯|Ğ¤Ğ¸Ğ´Ğ¶Ğ¸|Fiji|Fiji
PH|ğŸ‡µğŸ‡­|Ğ¤Ğ¸Ğ»Ğ¸Ğ¿Ğ¿Ğ¸Ğ½Ñ‹|Philippines|Pilipinas
FI|ğŸ‡«ğŸ‡®|Ğ¤Ğ¸Ğ½Ğ»ÑĞ½Ğ´Ğ¸Ñ|Finland|Suomi
FK|ğŸ‡«ğŸ‡°|Ğ¤Ğ¾Ğ»ĞºĞ»ĞµĞ½Ğ´ÑĞºĞ¸Ğµ Ğ¾ÑÑ‚Ñ€Ğ¾Ğ²Ğ°|Falkland Islands (Malvinas)|Falkland Islands
FR|ğŸ‡«ğŸ‡·|Ğ¤Ñ€Ğ°Ğ½Ñ†Ğ¸Ñ|France|France
GF|ğŸ‡¬ğŸ‡«|Ğ“Ğ²Ğ¸Ğ°Ğ½Ğ°|French Guiana|Guyane FranÃ§aise
PF|ğŸ‡µğŸ‡«|Ğ¤Ñ€Ğ°Ğ½Ñ†ÑƒĞ·ÑĞºĞ°Ñ ĞŸĞ¾Ğ»Ğ¸Ğ½ĞµĞ·Ğ¸Ñ|French Polynesia|PolynÃ©sie franÃ§aise
TF|ğŸ‡¹ğŸ‡«|Ğ¤Ñ€Ğ°Ğ½Ñ†ÑƒĞ·ÑĞºĞ¸Ğµ Ğ®Ğ¶Ğ½Ñ‹Ğµ Ğ¸ ĞĞ½Ñ‚Ğ°Ñ€ĞºÑ‚Ğ¸Ñ‡ĞµÑĞºĞ¸Ğµ Ñ‚ĞµÑ€Ñ€Ğ¸Ñ‚Ğ¾Ñ€Ğ¸Ğ¸|French Southern Territories|Terres australes et antarctiques franÃ§aises
HR|ğŸ‡­ğŸ‡·|Ğ¥Ğ¾Ñ€Ğ²Ğ°Ñ‚Ğ¸Ñ|Croatia|Hrvatska
CF|ğŸ‡¨ğŸ‡«|Ğ¦ĞĞ |Central African Republic|RÃ©publique Centrafricaine
TD|ğŸ‡¹ğŸ‡©|Ğ§Ğ°Ğ´|Chad|Tchad
ME|ğŸ‡²ğŸ‡ª|Ğ§ĞµÑ€Ğ½Ğ¾Ğ³Ğ¾Ñ€Ğ¸Ñ|Montenegro|Ğ¦Ñ€Ğ½Ğ° Ğ“Ğ¾Ñ€Ğ° / Crna Gora
CZ|ğŸ‡¨ğŸ‡¿|Ğ§ĞµÑ…Ğ¸Ñ|Czech Republic|ÄŒesko
CL|ğŸ‡¨ğŸ‡±|Ğ§Ğ¸Ğ»Ğ¸|Chile|Chile
CH|ğŸ‡¨ğŸ‡­|Ğ¨Ğ²ĞµĞ¹Ñ†Ğ°Ñ€Ğ¸Ñ|Switzerland|Schweiz
SE|ğŸ‡¸ğŸ‡ª|Ğ¨Ğ²ĞµÑ†Ğ¸Ñ|Sweden|Sverige
SJ|ğŸ‡¸ğŸ‡¯|Ğ¨Ğ¿Ğ¸Ñ†Ğ±ĞµÑ€Ğ³ĞµĞ½|Svalbard and Jan Mayen|Svalbard
LK|ğŸ‡±ğŸ‡°|Ğ¨Ñ€Ğ¸-Ğ›Ğ°Ğ½ĞºĞ°|Sri Lanka|à·à·Šâ€à¶»à·“ à¶½à¶‚à¶šà·à·€
EC|ğŸ‡ªğŸ‡¨|Ğ­ĞºĞ²Ğ°Ğ´Ğ¾Ñ€|Ecuador|Ecuador
GQ|ğŸ‡¬ğŸ‡¶|Ğ­ĞºĞ²Ğ°Ñ‚Ğ¾Ñ€Ğ¸Ğ°Ğ»ÑŒĞ½Ğ°Ñ Ğ“Ğ²Ğ¸Ğ½ĞµÑ|Equatorial Guinea|Guinea Ecuatorial
ER|ğŸ‡ªğŸ‡·|Ğ­Ñ€Ğ¸Ñ‚Ñ€ĞµÑ|Eritrea|Ø¥Ø±ØªØ±ÙŠØ§
SZ|ğŸ‡¸ğŸ‡¿|Ğ­ÑĞ²Ğ°Ñ‚Ğ¸Ğ½Ğ¸|Swaziland|Eswatini
EE|ğŸ‡ªğŸ‡ª|Ğ­ÑÑ‚Ğ¾Ğ½Ğ¸Ñ|Estonia|Eesti
ET|ğŸ‡ªğŸ‡¹|Ğ­Ñ„Ğ¸Ğ¾Ğ¿Ğ¸Ñ|Ethiopia|áŠ¢á‰µá‹®áŒµá‹«
ZA|ğŸ‡¿ğŸ‡¦|Ğ®ĞĞ |South Africa|South Africa
SS|ğŸ‡¸ğŸ‡¸|Ğ®Ğ¶Ğ½Ñ‹Ğ¹ Ğ¡ÑƒĞ´Ğ°Ğ½|South Sudan|South Sudan
JM|ğŸ‡¯ğŸ‡²|Ğ¯Ğ¼Ğ°Ğ¹ĞºĞ°|Jamaica|Jamaica
JP|ğŸ‡¯ğŸ‡µ|Ğ¯Ğ¿Ğ¾Ğ½Ğ¸Ñ|Japan|æ—¥æœ¬|ÑĞ¿Ğ¾Ğ½ÑĞºĞ¸Ğ¹